1111111111111111111
10000000000000G0001
1000000000000000001
1P00000000000000001
1000000000000000001
10000000000000000E1
1111111111111111111